,Overall,KM3_1,KM3_2,KM3_3,KM4_1,KM4_2,KM4_3,KM4_4,KM5_1,KM5_2,KM5_3,KM5_4,KM5_5,KM6_1,KM6_2,KM6_3,KM6_4,KM6_5,KM6_6,KM7_1,KM7_2,KM7_3,KM7_4,KM7_5,KM7_6,KM7_7,KM8_1,KM8_2,KM8_3,KM8_4,KM8_5,KM8_6,KM8_7,KM8_8
Seg_size,8950.0,2763.0,4667.0,1520.0,2443.0,1720.0,3646.0,1141.0,1880.0,1017.0,1716.0,3559.0,778.0,1760.0,949.0,727.0,914.0,1439.0,3161.0,1447.0,1753.0,1834.0,1793.0,704.0,618.0,801.0,368.0,1801.0,1772.0,1625.0,1125.0,695.0,137.0,1427.0
Seg_Pct,1.0,0.3087150837988827,0.5214525139664804,0.16983240223463686,0.2729608938547486,0.19217877094972066,0.40737430167597766,0.12748603351955307,0.2100558659217877,0.11363128491620111,0.191731843575419,0.3976536312849162,0.08692737430167598,0.19664804469273742,0.10603351955307262,0.08122905027932961,0.10212290502793296,0.16078212290502794,0.3531843575418994,0.1616759776536313,0.1958659217877095,0.20491620111731843,0.20033519553072626,0.07865921787709497,0.06905027932960894,0.08949720670391062,0.04111731843575419,0.2012290502793296,0.19798882681564245,0.18156424581005587,0.12569832402234637,0.0776536312849162,0.015307262569832402,0.1594413407821229
BALANCE,1541.0466889385496,2511.2347188201265,783.6388534176167,2103.0156638157855,2411.5899205075752,1231.3136288372098,867.3788361492057,2296.696767747587,1873.0213323404262,2220.320932645032,1084.7572046620069,846.424361758922,4034.9019357326465,2044.7114088068176,55.54569146469965,4094.004950481429,2279.135388402623,1330.545281792912,1001.8465424865544,1325.5995926053909,2041.9338616657146,645.8259489094879,1446.2424982710543,4136.791470880681,2526.551819579288,54.2414310861423,3012.2669497282623,1926.6280181565783,1508.73417663657,1166.4279847384628,1497.8000839999984,4112.454238129496,22.703322627737204,69.22423714085481
BALANCE_FREQUENCY,0.8782301675977594,0.9135903003981183,0.8235461752731954,0.9818552631578958,0.8975849365534196,0.8245813953488375,0.8579648930334627,0.9824189307624897,0.8770425531914903,0.982251720747296,0.7915384615384613,0.871298117448723,0.9680462724935728,0.9317784090909109,0.33385669125395273,0.9669738651994495,0.9812144420131291,0.9061779013203625,0.9489370452388498,0.9045611610228069,0.9315231032515704,0.9102235550708857,0.9628443948689371,0.9657670454545451,0.9832038834951456,0.29344569288389805,0.9858695652173914,0.8916990560799567,0.9759988713318303,0.8302338461538465,0.9761777777777778,0.9668633093525175,0.2535036496350364,0.7063139453398736
PURCHASES,936.2292368715101,127.34908432862818,597.3384272551948,3447.1103355263162,74.96985264019646,639.5262790697678,695.9304415798125,3995.4011656441708,4.600042553191489,4223.322625368731,602.615081585082,734.1883394211842,550.6692802056558,7.293920454545455,298.13972602739744,563.0387207702892,4460.669967177245,661.8349061848508,836.6712559316666,673.0811886662061,6.548625213918997,612.9658942202846,1316.4920468488567,538.1340340909093,5346.439595469258,282.431622971286,6565.3123641304455,2.492254303164908,637.7386173814893,639.446978461539,2315.970577777777,542.0890215827341,458.73781021897804,521.7155921513672
ONEOFF_PURCHASES,536.4937740782138,89.20212812160685,295.03530747803677,2090.9368539473667,41.499905853458884,639.580889534884,205.3614015359302,2499.043127081509,0.19616489361702125,2663.9006291052133,599.0809906759912,224.80262433267825,339.29052467866296,0.9891022727272727,137.4824552160168,343.4313317744151,2821.0678225382953,661.8863446838084,281.1839892439107,673.1461022805807,0.1846662863662293,14.201194111232281,760.9859788064683,332.7103383522724,3369.2471841423917,150.23403245942563,4178.323042934783,0.0,185.47608916478598,639.504781538462,1392.1619822222228,341.10939309352483,189.15715328467152,46.93042046250876
INSTALLMENTS_PURCHASES,384.4983681564239,38.19099167571481,302.7136533104769,1265.1145164473699,33.519750306999605,0.0,490.88598793197923,1375.6365758106938,4.450127659574467,1426.2312020648983,3.58882867132867,509.71041078954664,208.48231426735202,6.354221590909091,160.97002107481572,216.50775859697376,1491.4018845733049,0.013835997220291869,555.7589503321725,0.0,6.413559612093556,597.4984640130872,555.7047127718918,202.22279900568176,1762.9483357605168,132.28435705368292,2034.378421195651,2.5405330372015538,452.73084678329695,0.0,918.5132928888893,197.737281294964,269.5806569343065,475.1977298528386
CASH_ADVANCE,935.9209939664796,2324.666845313063,212.70181701307058,632.0783042105267,2270.063329676626,590.272170232558,271.5607395501922,723.3563474145493,1426.4285329787242,474.65499705014713,432.46761072261074,233.00847991008715,4679.552084832903,1464.9491488636368,254.33664531085353,4809.877861898211,486.2235032822753,528.734781097985,270.413818411895,523.9587353144439,1446.4200716486023,189.67382224645584,396.44451199107675,4906.192337499999,527.3586601941746,304.8643730337079,583.9577326086958,1458.9485317046085,472.1532279909712,463.47963692307695,344.57714666666647,4938.654688345323,389.1568350364965,49.6786475122635
PURCHASES_FREQUENCY,0.4902167597765341,0.0960694896851251,0.5776323119777135,0.9382828947368437,0.06345886205485059,0.3161802325581389,0.7157871640153599,0.9455039439088513,0.009085106382978722,0.9477384464110115,0.3047027972027958,0.732865973588087,0.3539460154241645,0.012261363636363633,0.2874710221285567,0.35693259972489694,0.9479540481400424,0.33996525364836566,0.7839038279025634,0.34161022805805,0.012544209925841415,0.7916848418756831,0.7776073619631905,0.33835227272727286,0.9534951456310676,0.24654182272159803,0.9504619565217396,0.004602998334258745,0.6972573363431148,0.31705846153846,0.9189866666666656,0.32532374100719424,0.42824817518248165,0.672733006306937
ONEOFF_PURCHASES_FREQUENCY,0.2021765363128463,0.04761491132826633,0.1563852581958448,0.623730263157895,0.02271796970937371,0.31598255813953424,0.11463247394404781,0.6946012269938647,0.00022340425531914895,0.7100491642084557,0.29889860139859986,0.1245743186288278,0.16795629820051403,0.000375,0.04757639620653305,0.1692572214580467,0.7214004376367605,0.33967338429464783,0.1557956342929447,0.3413752591568751,0.00018824871648602396,0.008685932388222465,0.38407138873396707,0.1594176136363636,0.7386245954692555,0.05232209737827699,0.7588858695652171,0.0,0.10500564334085828,0.3168492307692292,0.5989955555555554,0.16260431654676255,0.060218978102189784,0.02391730903994389
PURCHASES_INSTALLMENTS_FREQUENCY,0.3645530726256994,0.050448787549764756,0.4248810799228637,0.7502894736842094,0.04199345067539912,0.0,0.6305320899616036,0.7548115687992974,0.00778191489361702,0.7531661750245816,0.004871794871794873,0.6445153132902525,0.23131105398457585,0.010482954545454542,0.22759747102212838,0.23555708390646493,0.7549890590809627,5.5594162612925644e-05,0.6855172413793121,0.0,0.01090701654306902,0.7505398037077442,0.6039542665923028,0.21982954545454536,0.7768932038834957,0.1864794007490637,0.775407608695652,0.003981121599111606,0.6164051918735883,0.0,0.7122222222222215,0.20303597122302153,0.37445255474452555,0.6196916608269084
CASH_ADVANCE_FREQUENCY,0.13373966480447,0.320188201230548,0.03852581958431548,0.08716447368421047,0.31040933278755767,0.0948023255813954,0.04545803620405927,0.09626643295354949,0.21997872340425526,0.06749262536873153,0.07340909090909094,0.04097780275358242,0.5693573264781485,0.2301477272727271,0.026859852476290826,0.5804539202200818,0.0668927789934354,0.09029881862404447,0.04851312875672252,0.08975812024879062,0.22894466628636612,0.028282442748091576,0.07619074177356377,0.585383522727272,0.06503236245954688,0.031173533083645434,0.0681521739130434,0.2266129927817877,0.08235891647855526,0.0788369230769231,0.059964444444444404,0.5882014388489202,0.033722627737226285,0.006187806587245969
CASH_ADVANCE_TRX,3.0793296089385476,7.591748099891422,0.6989500749946432,2.1855263157894735,7.404830126893164,1.8930232558139535,0.9119583104772353,2.5319894829097285,4.221276595744681,1.5889872173058013,1.3508158508158508,0.7721270019668446,16.63496143958869,4.449431818181818,0.505795574288725,17.063273727647868,1.5940919037199124,1.708825573314802,0.9262891490034799,1.6924671734623358,4.413006274957216,0.514721919302072,1.5192414947016175,17.31534090909091,1.690938511326861,0.5892634207240949,1.9103260869565217,4.362021099389228,1.6551918735891649,1.4670769230769232,1.2044444444444444,17.427338129496402,0.5401459854014599,0.10021023125437982
PURCHASES_TRX,14.151385474860328,1.8269996380745566,10.342084851082067,48.25025657894743,1.2013917314776914,6.224133720930233,13.97792375205705,54.38289219982483,0.1202127659574468,56.37156342182903,5.897733100233101,14.65622646810902,8.762210796915166,0.16647727272727272,4.216016859852476,9.041265474552958,58.68367614879663,6.698061153578874,16.612625751344513,6.7874982722874915,0.16371933827723903,13.592971646673938,22.66677635248188,8.526988636363637,68.0167475728157,3.6679151061173534,77.93690217391324,0.06218767351471405,13.9856151241535,6.230467692307692,36.63386666666668,8.251798561151078,6.430656934306569,10.599859845830414
CREDIT_LIMIT,4474.254539664804,4492.588208469056,3675.1461131347755,6894.506578947368,4391.410835038887,4265.63090116279,3712.1575178277562,7401.358457493427,3608.333335106383,7462.881022615536,4154.3037004662,3722.2186878336606,6805.912596401028,3642.6231079545455,3746.8276501580613,6953.713892709766,7661.816192560175,4131.0645031271715,3819.9842454919326,4146.5803870076015,3627.9045464917285,3270.1090785169026,4824.563820412716,7000.78125,8205.258899676375,3792.1805992509367,9104.347826086956,3623.551732370905,3498.962251693002,4183.067784615384,6022.961617777778,6971.36690647482,3857.299270072993,3518.6638962859142
PAYMENTS,1649.4203690502848,1792.2653631559886,969.1940110563559,3478.3254309210565,1814.3001313958237,1202.8565652325574,1001.1053002742713,4041.2216170026304,1307.752737765958,4052.7723480825966,1115.0038685897428,1016.330935965157,3408.22524215938,1219.1693167045457,1165.5430998946263,3501.1159950481424,4286.327295404813,1093.149937456566,1099.1511127491294,1104.9193434692459,1208.776330519111,888.8601839694661,1521.6598570552126,3533.894216477271,5137.242007443363,1277.5609431960054,6426.281604891297,1259.067513714603,1112.9249625846485,1117.5202014769218,2232.090818755556,3551.451335827337,2185.0965583941615,744.9668122634903
MINIMUM_PAYMENTS,736.4005004469295,988.985068440104,509.61420580672745,973.5850239473684,947.5488705689725,573.1249889534886,583.8637732857919,1017.8617789658193,802.4328396808522,970.2730349065876,519.9253735431236,574.0279649901653,1491.3696600257083,866.4240219318194,97.76326659641725,1520.8644504814304,994.7861656455134,613.8338992355806,656.4033117684278,612.2844029025574,869.9426638334294,620.3000052889859,661.1012095928616,1530.7058742897725,1143.6629195792864,90.40469413233453,1415.6897067934783,810.3571224319834,984.371589954852,551.5431698461541,616.3932315555551,1512.0462381294963,15.669124087591236,156.5046881569728
PRC_FULL_PAYMENT,0.15353407821229043,0.033007600434310544,0.191281337047354,0.256723684210526,0.04117069177241099,0.09623837209302333,0.21617388919363678,0.2803242769500436,0.04220744680851065,0.2966076696165191,0.0939335664335665,0.22488901376791234,0.040565552699228756,0.022079545454545445,0.2595890410958906,0.041499312242090754,0.3087527352297593,0.08605281445448226,0.20649161657703238,0.09004837595024189,0.022093553907586987,0.31898582333696823,0.11737311767986644,0.04187499999999997,0.3371521035598706,0.2144694132334583,0.33997282608695645,0.031643531371460275,0.019531602708803567,0.09921846153846162,0.2334666666666669,0.04293525179856112,0.058832116788321155,0.4874842326559206
TENURE,11.51731843575419,11.321389793702497,11.529676451682024,11.835526315789474,11.308227589029881,11.484302325581396,11.569665386725179,11.847502191060473,11.37659574468085,11.859390363815143,11.520979020979022,11.576285473447598,11.132390745501285,11.434659090909092,11.412012644889357,11.132049518569463,11.854485776805252,11.507296733842946,11.590635874723189,11.51347615756738,11.436394751853964,11.452562704471102,11.760178471834914,11.098011363636363,11.880258899676376,11.394506866416979,11.89945652173913,11.390338700721822,11.677765237020315,11.507692307692308,11.812444444444445,11.096402877697841,11.416058394160585,11.37281009110021
MONTHLY_AVG_PURCHASE,80.55621687150827,11.715808903365902,52.398628669380734,292.1466848684209,6.869529267294307,57.36677906976739,60.263831596270016,338.1271612620506,0.39759574468085096,357.1136667649948,53.63682400932397,63.45477662264687,50.34668624678664,0.626528409090909,26.00963119072705,51.49555969738651,377.0840362144417,59.14884642112583,72.12434039860804,60.05778161713893,0.5644894466628635,53.68133587786267,112.26538204127169,49.33926406250002,451.25880113268556,24.6302122347066,553.5364105978252,0.21173792337590228,54.76152934537245,57.06621538461536,196.6352888888889,49.76269338129498,39.356423357664255,46.20446391030139
MONTHLY_AVG_CASH_ADVANCE,84.92110793296091,212.63445834238203,19.027923719734343,55.08657078947371,208.33155472779373,53.00399430232559,24.07708540866707,63.22349184925511,129.43875553191458,41.033533529990166,38.38252529137525,20.605872436077558,431.5774275064268,132.84881079545423,22.965440885142264,443.74554140302587,42.15365820568926,47.02956455872127,23.92559633027527,46.49839903248094,131.0690855675981,17.324874591057792,34.0938706079197,453.43403210227274,46.27932621359225,27.80813158551811,51.239439130434796,132.51098667406964,41.649650112866816,41.078875938461486,29.475999999999992,456.7384871942446,34.768710948905124,4.640574632095305
LIMIT_USAGE,0.38600000000000867,0.5945313065508513,0.2794128990786317,0.33420394736842074,0.5792304543593952,0.36519767441860346,0.28408392759187645,0.32929886064855374,0.567813829787234,0.3131268436578171,0.33968531468531377,0.2824838437763368,0.6176092544987158,0.6160284090909097,0.01887249736564802,0.6107427785419541,0.3096608315098472,0.4121959694232099,0.32660234103131425,0.4102073255010359,0.6166457501426134,0.2534841875681548,0.3752035694366968,0.61174715909091,0.31870550161812294,0.018589263420724016,0.34614130434782614,0.5791726818434202,0.5180812641083498,0.3628184615384606,0.2780088888888889,0.6109928057553964,0.006204379562043797,0.026881569726699535
PAYMENT_MINPAYMENT,6.665068044692749,3.7689733260948235,7.342267966573832,9.850211250000013,5.137046336471551,6.418813837209305,6.385500246845867,11.201280543383014,5.462422446808516,11.817110226155368,7.0167461538461575,6.232213346445639,4.040899742930586,2.669977272727272,24.176509905163403,4.128294360385139,12.48567954048141,3.7258790826963164,3.870601075608984,3.7840359364201803,2.641825442099258,3.778173391494003,4.778600111544899,4.041988636363632,14.557493689320394,27.723405617977594,16.076874999999994,3.3308328706274337,2.41255643340858,4.626461538461538,7.736711111111112,4.18815827338129,116.38685401459863,5.875697266993697
PURCHASE_TYPE_NONE,0.22815642458100557,0.7260224393774882,0.00771373473323334,0.0,0.8358575521899304,0.0,0.0,0.0,0.9521276595744681,0.0,0.0,0.0,0.32390745501285345,0.9386363636363636,0.1601685985247629,0.32737276478679506,0.0,0.0,0.0,0.0,0.9383913291500285,0.0,0.0,0.3494318181818182,0.0,0.18851435705368288,0.0,0.9700166574125486,0.0,0.0,0.0,0.3539568345323741,0.24817518248175183,0.01051156271899089
PURCHASE_TYPE_ONEOFF_INSTALLMENT,0.3099441340782123,0.06731813246471227,0.2530533533319049,0.9256578947368421,0.05853458862054851,0.0,0.42484914975315413,0.9482909728308502,0.0010638297872340426,0.9400196656833825,0.0,0.44169710592863165,0.31362467866323906,0.002840909090909091,0.08956796628029505,0.31911966987620355,0.936542669584245,0.0,0.5049035115469788,0.0,0.0017113519680547634,0.07197382769901854,0.9994422755158952,0.2869318181818182,0.9174757281553398,0.09737827715355805,0.8885869565217391,0.0,0.5095936794582393,0.0,0.9866666666666667,0.2762589928057554,0.10218978102189781,0.15977575332866154
PURCHASE_TYPE_ONE_OFF,0.2093854748603352,0.14947520810712994,0.2982644096850225,0.045394736842105265,0.044207941056078594,1.0,0.0,0.040315512708150744,0.0,0.048180924287118974,0.9557109557109557,0.0,0.2377892030848329,0.0,0.23603793466807166,0.22833562585969738,0.05032822757111598,0.9993050729673384,0.0,1.0,0.0,0.0,0.0,0.23579545454545456,0.06796116504854369,0.27340823970037453,0.08967391304347826,0.0,0.0,1.0,0.008,0.25611510791366904,0.20437956204379562,0.000700770847932726
cluster_3,0.8611173184357542,0.0,1.0,2.0,0.01882930822758903,0.836046511627907,1.0814591332967636,1.9982471516213847,0.03829787234042553,2.0,0.8776223776223776,1.1098623208766507,0.18637532133676094,0.026704545454545453,0.8724973656480506,0.19257221458046767,2.0,0.8443363446838082,1.1543815248339133,0.848652384243262,0.027381631488876214,1.0239912758996728,1.4071388733965422,0.16193181818181818,2.0,0.8489388264669163,2.0,0.007773459189339256,0.9932279909706546,0.8707692307692307,1.8746666666666667,0.1510791366906475,0.927007299270073,1.0098107918710582
cluster_4,1.3893854748603351,0.15490408975750997,1.682022712663381,2.7348684210526315,0.0,1.0,2.0,3.0,0.027659574468085105,2.992133726647001,1.0442890442890442,2.014048890137679,0.4884318766066838,0.042045454545454546,1.4373024236037935,0.47042640990371387,2.99781181619256,1.0006949270326615,2.048402404302436,1.0041465100207325,0.042213348545350825,2.0021810250817884,2.241494701617401,0.40625,3.0,1.344569288389513,3.0,0.001110494169905608,1.950902934537246,1.0036923076923077,2.6373333333333333,0.39280575539568346,1.313868613138686,1.97687456201822
cluster_5,2.0377653631284915,1.2066594281577996,2.642382686950932,1.6921052631578948,0.9598853868194842,2.0860465116279068,2.9764125068568292,1.273444347063979,0.0,1.0,2.0,3.0,4.0,0.06875,2.198103266596417,3.9917469050894083,1.0,2.0250173731758165,2.9424232837709585,2.020041465100207,0.05932686822589846,2.995092693565976,2.5950920245398774,3.965909090909091,1.0,2.066167290886392,1.0,0.01776790671848973,2.9672686230248306,2.0043076923076923,1.8764444444444444,3.9913669064748203,1.9416058394160585,2.923615977575333
cluster_6,2.9839106145251395,0.925805284111473,3.9852153417613025,3.650657894736842,0.5370446172738437,3.542441860465116,4.276741634668129,3.249780893952673,0.08191489361702127,3.1937069813176007,3.474941724941725,4.4239955043551555,2.051413881748072,0.0,1.0,2.0,3.0,4.0,5.0,3.9827228749136143,0.008556759840273816,4.688113413304253,4.613496932515337,1.9886363636363635,3.0,1.00374531835206,3.0,0.05830094392004442,4.760158013544018,3.6375384615384614,4.005333333333334,2.014388489208633,1.0291970802919708,3.5767344078486336
cluster_7,2.4035754189944134,1.862468331523706,2.2804799657167347,3.7651315789473685,2.0106426524764633,0.8965116279069767,2.842841470104224,4.113058720420684,1.4111702127659576,4.192723697148476,1.025058275058275,2.778589491430177,3.7879177377892033,1.0204545454545455,5.349841938883035,3.9491059147180194,4.335886214442013,0.008339124391938846,2.4653590635874725,0.0,1.0,2.0,3.0,4.0,5.0,6.0,5.0,1.2909494725152693,2.5062076749435667,0.7009230769230769,3.4186666666666667,3.9266187050359713,5.985401459854015,3.063770147161878
cluster_8,3.2408938547486033,2.1639522258414767,3.9565031069209344,3.001315789473684,2.024559967253377,3.1313953488372093,4.261930883159627,2.747589833479404,1.1585106382978723,2.551622418879056,3.219114219114219,4.227592020230402,4.708226221079691,1.05,5.337197049525817,4.8198074277854195,2.3916849015317285,3.015983321751216,3.816197405884214,3.015894955079475,1.038220193953223,4.7715376226826605,3.100948131622978,4.890625,1.6262135922330097,5.072409488139825,0.0,1.0,2.0,3.0,4.0,5.0,6.0,7.0
